1111111111111111111111111
1111C1110000E0000111C1111
110C00011100000111000C011
1000000011C111C1100000001
1000000000001000000000001
1000000000000000000000001
1C000000000000000000000C1
1000100010001000100010001
100111C111C111C111C111001
1011111111111111111111101
100111C111C111C111C111C01
1000100010001000100010001
1100000000000000000000011
1110000000000000000000111
1111000000C000C0000001111
1111100000CC0CC0000011111
1111110000C0C0C0000111111
1111111000C000C0001111111
1111111100000000011111111
1111111110000000111111111
1111111111000001111111111
1111111111100011111111111
111111111111P111111111111
1111111111111111111111111