111111111111111
1E0000000000001
111111011111101
1C0001C1000C001
101111111111101
1P00000000000C1
111111111111111