11111111111111111111
1P001C000001C10000E1
10111011101100111101
1C0010001010000001C1
10111011101110111101
10000C00100C00000001
11111111111111111111