1111111111111111111111111
1P00C0001C0000C0001C000E1
1011101011001011101001111
10C0010C00010C00000C00001
1111111111111111111111111